1111111111111111111111111111111111
1E0000000000000C00000C000000000001
1010010100100000101001000000010101
101001001010101000100100000C010101
1010010100100000101001000000010101
10100101000000001010010000C0010101
101000010000C00010100000C000010101
1010000100000000101001000000010101
10100001001C00C0101001000000010101
1010C00100100P001010010000000101C1
1010000010101010001000001110010101
1010010011101010X01001000000010101
101C010000101010001001000000010101
1010000C00101010001001000000010101
10100100001010100C1001000000C10101
10100C00001010100010010C0000010101
1010000010101010001001000000010101
100000000C00C0000000000000000000C1
1111111111111111111111111111111111
