1111111111111
1001000P00011
1C00011E111
1010111000001
1111111111111
