1111111111111
1001000P00011
10W0011E11001
1010111000001
1111111111111
