1111111111111
1001000P00011
1000011E11001
1010111000001
1111111111111
