1111111111111
1001000P00011
1C00011011001
10101110EE001
1111111111111
