1111111111111
10010P00P0011
1C00011E11001
1010111000001
1111111111111
